24 24 2 1
1 1 1 1 1 1 1 1 1 1 1 1 1 1 1 1 1 1 1 1 1 1 1 1
1 0 1 2 2 0 0 0 0 0 0 0 0 0 0 0 0 0 0 0 0 0 4 1
1 0 1 2 0 0 0 2 3 3 3 4 4 4 4 5 5 0 0 5 4 0 4 1
1 0 1 2 0 0 0 2 3 0 3 4 0 0 4 5 0 0 0 5 4 0 4 1
1 0 1 2 0 0 0 2 3 0 3 4 0 0 4 5 0 0 0 5 4 0 4 1
1 0 1 2 0 0 0 2 3 0 3 4 0 0 4 5 0 0 0 5 4 0 4 1
1 0 1 2 0 0 0 2 3 0 3 4 0 0 4 5 0 0 0 5 4 0 4 1
1 0 1 2 0 0 0 2 0 0 0 0 0 0 4 5 0 0 0 5 4 0 4 1
1 0 1 2 2 2 0 2 3 3 0 0 0 0 4 5 0 0 0 5 4 0 4 1
1 0 1 1 1 1 0 1 1 1 0 0 0 0 4 5 0 0 0 5 4 0 4 1
1 0 0 0 0 0 0 0 0 0 0 0 0 0 4 5 0 0 0 5 4 0 4 1
1 0 1 1 1 1 1 1 1 0 0 0 0 1 1 1 0 0 0 5 4 0 4 1
1 0 0 0 0 0 0 0 0 0 0 0 0 0 0 0 0 0 0 5 4 0 4 1
1 0 0 0 0 0 0 0 0 0 0 0 0 4 4 4 0 0 0 5 4 0 4 1
1 0 1 1 0 1 1 1 1 1 1 1 1 1 1 1 1 1 1 1 4 0 4 1
1 0 1 6 0 0 6 1 9 9 9 9 9 9 9 9 9 9 9 1 4 0 4 1
1 0 1 6 0 0 6 1 9 0 0 0 0 0 0 0 0 0 9 1 4 0 4 1
1 0 1 6 0 0 6 1 9 0 0 0 0 0 0 0 0 0 9 1 4 0 4 1
1 0 1 6 0 0 0 8 0 0 0 0 0 0 0 0 0 0 7 1 4 0 4 1
1 0 1 6 0 0 6 1 9 0 0 0 0 0 0 0 0 0 9 1 4 0 4 1
1 0 1 6 0 0 6 1 9 0 0 0 0 0 0 0 0 0 9 1 4 0 4 1
1 0 1 6 6 6 6 1 9 9 9 9 9 9 9 9 9 9 9 1 4 0 4 1
1 0 1 1 1 1 1 1 1 1 1 1 1 1 1 1 1 1 1 1 4 4 4 1
1 1 1 1 1 1 1 1 1 1 1 1 1 1 1 1 1 1 1 1 1 1 1 1
